11111
1P1C1
10001
1E001
11111
