111111111111
1101C1111111
10000000C101
1P000000E011
111111111111
