1111111111111111111111111111111111
1C0000000000N000000000000000000E01
1010010100101010100101001010010101
1010010010101000000101010010010101
1P0000C0000000C0000000N00000000001
1111111111111111111111111111111111
