1111111111111111111111111111111111
1C000000000000000N0000000000000E01
1010010100101010001001001001001011
1010010010101000000101010101010011
1P0000C000000000000000000000000N01
1111111111111111111111111111111111
