11111111111111111111
1P0100101000000100E1
1001000000C001111101
10010010101001000001
10000010101001000001
100C0011111001010001
11110010000001010C01
10000010000001010001
10001110000000010001
1000001000C000010001
11111010000001000001
100C0011100011010001
11111110000001010001
10000010111111010001
10000000100000000001
10111110001111111111
10000000000000000001
10000000000000000001
11111111111111111111
