1111111111111111111111111111111111
1E000000000000000000000000000000C1
1010010100100000101001000000010101
1010010010101010001001000000010101
1P0000C00000000C000000000000000001
1010010010100000101001001010010101
1010010010101010101001001010010101
1C0000C000000000000000000000000001
1010010010101010001010010010010101
1010010010100000101001010000010101
100000C0000000000C0000000000000001
1111111111111111111111111111111111
